LLLLLLLLLLLLLLSSLLLLLLLLLLLLLLLLLLLLLLLL
LLLLLLLLLLLLLLSSLLLLLLLLLLLLLLLLLLLLLLLL
LLLLLKKLSSSSSSSSSSSSLLLLSSSSSSSSSSSSSSLL
LLLLLKKLSSSSSSSSSSSSLLLLSSSSSSSSSSSSSSLL
LLLLLSSLSSLLLLLLLLSSLLLLSSLLLLLLSSLLSSLL
LLLLLSSLSSLLLLLLLLSSLLLLSSLLLLLLSSGLSSLL
LLSSSSSSSSLLSSSSSSSSSSSSSSSSSSLLSSLLSSLL
LLSSSSSSSSLLSSSSSSSSSSSSSSSSSSLLSSLLSSLL
LLSSLLLLSSLLSSLLLLSSLLLLSSLLSSLLSSLLSSLL
LLSSLLLLSSLLSSFFLLSSLLLLSSLLSSLLSSLLSSLL
LLSSLLLLSSLLSSFFLLSSLLLLSSLLSSSSSSLLSSLL
LLSSLLLLSSLLSSLLLLSSLLLLSSLLSSSSSSLLSSLL
LLSSLLLLSSSSSSLLLLSSLLLLSSLLLLLLSSLLSSLL
LLSSLLLLSSSSSSLLLLSSLLLLSSLLLLLLSSLLSSLL
LLWWLLLLGLLLSSLLLLSSSSSSSSSSSSSSSSLLSSLL
LLWWLLLLLLLLSSLLLLSSSSSSSSSSSSSSSSLLSSLL
LLLLLLLLLLLLSSLLLLSSLLLLSSLLLLLLSSLLSSLL
LLLLLLLLLLLLSSLLLLSSLLLLSSLLLLLLSSLLSSLL
LLPPSSSSSSSSSSSSSSSSLLLLSSLLLLLLSSLLSSLL
LLPPSSSSSSSSSSSSSSSSLLLLSSLLLLLLSSLLSSLL
LLLLSSLLLLLLSSLLLLSSLLLLSSLLLLLLSSSSSSLL
LLLLSSLLLLLLSSLLLLSSLLLGSSLLLLLLSSSSSSLL
LLSSSSLLLLLLSSLLLLSSLLLLSSLLLLLLSSLLFFLL
LLSSSSLLLLLLSSLLLLSSLLLLSSLLLLLLSSLLFFLL
LLSSLLLLLLLLSSLLLLSSSSSSSSSSSSSSSSLLLLLL
LLSSLLLLGLLLSSLLLLSSSSSSSSSSSSSSSSLLLLLL
LLSSSSSSSSSSSSLLLLLLLLOOLLLLLLLLSSLLLLLL
LLSSSSSSSSSSSSLLLLLLLLOOLLLLLLLLSSSSSSWW
LLLLLLLLLLLLLLLLLLLLLLLLLLLLLLLLSSSSSSWW
LLLLLLLLLLLLLLLLLLLLLLLLLLLLLLLLSSLLLLLL