0000000000000055000000000000000000000000
0000000000000055000000000000000000000000
0000000077777777777700001111111111111100
0000000077777777777700001111111111111100
0000033077000000007700001100000033001100
0000033077000000007700001100000033001100
0033333377005555557755555555550033001100
0033333377005555557755555555550033001100
0033000077005500007700003300330033001100
0033000077005500007700003300330033001100
0033000077005500007700003300333333001100
0033000077005500007700003300333333001100
0033000077775500007700003300000033001100
0033000077775500007700003300000033001100
0000000000005500007777777777777777001100
0000000000005500007777777777777777001100
0000000000005500005500003300000077001100
0000000000005500005500003300000077001100
0000333333335533335500003300000077001100
0000333333335533335500003300000077001100
0000330000005500005500003300000077777700
0000330000005500005500003300000077777700
0033330000005500005500003300000055000000
0033330000005500005500003300000055000000
0033000000005500005555555555555555000000
0033000000005500005555555555555555000000
0033777777775500000000000000000055000000
0033777777775500000000000000000055555500
0000000000000000000000000000000055555500
0000000000000000000000000000000055000000